TILEMAP
30 20 			-- Size of tile map in tiles
16 16 			-- Tile size & block size
images/TileMap.png 	-- Tilesheet
30 20 			-- Number of tiles in tilesheet



85 85 85 85 85 85 85 85 85 259 260 261 259 260 261 169 169 169 169 169 259 260 261 259 260 261 85 85 85 15
85 85 85 85 85 85 85 85 85 289 290 291 289 290 291 199 199 39 40 41 289 290 291 289 290 291 124 125 126 15
255 256 257 31 31 54 124 125 126 319 320 321 319 320 321 229 229 69 70 71 319 320 321 319 320 321 154 155 156 15
285 286 287 31 31 54 154 155 156 43 43 43 43 43 43 43 43 99 100 101 43 43 43 43 43 22 184 185 186 36
315 316 317 31 31 54 184 185 186 66 36 66 65 66 35 36 35 36 35 35 36 36 36 36 35 36 36 36 35 36
282 283 284 31 31 54 43 36 65 66 66 66 38 65 35 35 97 36 65 35 38 35 38 36 65 66 66 66 36 36
312 313 314 31 31 54 43 66 65 66 65 97 66 36 35 35 36 66 35 65 65 35 35 35 65 66 65 66 66 36
195 196 197 31 31 54 43 35 0 1 2 65 35 0 1 2 35 0 1 2 35 0 1 2 65 0 1 2 66 66
225 13 227 31 31 54 43 35 30 31 32 66 35 30 31 32 35 30 31 32 65 30 31 32 35 30 22 32 66 66
255 256 257 31 31 54 43 97 60 61 62 35 35 60 61 62 65 60 61 62 97 60 61 62 65 60 61 62 65 66
285 286 287 31 31 54 43 43 36 36 36 35 97 35 36 65 65 65 65 65 65 65 65 65 66 36 65 35 65 97
315 316 317 31 31 54 86 43 0 1 2 35 65 0 1 2 35 0 1 2 36 0 1 2 66 0 1 2 65 65
31 31 31 282 283 284 54 43 30 31 32 35 35 30 31 32 35 30 31 32 35 30 31 32 66 30 23 32 65 66
282 283 284 312 313 314 54 43 60 61 62 65 35 60 61 62 35 60 61 62 65 60 61 62 36 60 61 62 65 66
312 313 314 282 283 284 54 43 35 35 35 65 35 35 36 65 65 35 36 65 65 66 66 66 35 36 36 65 66 66
195 196 197 312 313 314 54 43 35 35 35 35 97 35 35 36 35 35 35 35 36 65 35 35 35 36 66 66 65 66
225 13 227 282 283 284 54 43 38 35 35 35 65 65 35 35 36 65 97 35 35 35 65 65 35 36 65 66 97 66
255 256 257 312 313 314 54 43 35 35 35 5 6 36 65 35 35 35 35 65 65 65 65 38 35 35 36 35 65 66
285 460 287 282 283 284 54 43 38 65 65 33 34 35 65 38 65 65 65 35 35 35 35 35 65 35 35 35 65 66
315 460 317 312 313 314 54 43 35 35 35 63 64 65 65 66 65 65 66 65 65 65 65 65 97 65 65 65 65 66
