TILEMAP
15 10 			-- Size of tile map in tiles
16 16 			-- Tile size & block size
images/TileMap2.png 	-- Tilesheet
30 20 			-- Number of tiles in tilesheet

3 4 33 34 33 34 33 34 30 31 32 33 34 8 33
33 34 63 64 63 64 63 64 30 31 32 63 64 38 3
3 4 66 36 38 38 38 35 30 31 32 92 38 97 33
33 34 35 0 1 1 1 1 151 31 32 92 97 66 3
3 4 38 30 31 31 31 31 31 31 32 92 38 97 33
33 34 35 30 31 120 61 61 61 61 62 93 90 90 3
3 4 38 30 31 32 66 94 95 95 95 95 95 96 33
33 34 97 30 31 32 66 124 125 125 125 125 125 126 3
3 4 65 30 31 32 66 154 155 155 155 155 155 156 33
33 34 66 30 31 32 97 154 155 155 155 155 155 156 63
