TILEMAP
15 10 			-- Size of tile map in tiles
16 16 			-- Tile size & block size
images/TileMap2.png 	-- Tilesheet
30 20 			-- Number of tiles in tilesheet

258 259 260 261 169 169 169 169 169 169 169 259 260 261 262
288 289 290 291 199 199 199 199 199 336 199 289 290 291 292
318 319 320 321 201 229 334 335 335 366 229 319 320 321 322
348 210 210 210 231 210 364 365 365 396 210 210 210 210 352
227 245 246 247 210 210 210 330 331 332 210 210 210 210 225
227 275 398 277 210 210 210 360 361 362 363 210 210 210 225
227 275 397 244 246 247 394 390 391 392 210 210 210 210 225
227 275 248 278 279 277 210 420 421 422 210 210 210 210 225
227 305 306 306 306 307 210 210 210 210 210 210 210 210 225
379 196 196 196 196 196 196 196 196 196 197 210 210 195 381
