TILEMAP
15 10 			-- Size of tile map in tiles
16 16 			-- Tile size & block size
images/TileMap2.png 	-- Tilesheet
30 20 			-- Number of tiles in tilesheet

3 4 30 12 14 42 9 10 11 44 12 13 13 13 14
33 34 30 72 74 42 39 40 41 44 72 75 75 75 74
63 64 30 73 43 72 69 70 71 74 43 73 73 23 73
1 1 151 43 73 43 99 100 101 43 73 73 43 43 73
61 61 61 121 22 73 43 43 43 73 22 73 43 43 73
1 1 2 30 73 73 73 73 73 73 73 73 73 73 73
31 31 32 30 43 23 43 73 73 73 43 73 73 43 73
61 61 62 30 73 73 73 73 73 47 17 73 73 73 73
1 1 1 151 73 43 73 23 73 72 74 73 43 73 22
43 73 22 73 73 73 73 73 73 43 73 73 23 73 73
