TILEMAP
15 10 			-- Size of tile map in tiles
16 16 			-- Tile size & block size
images/TileMap2.png 	-- Tilesheet
30 20 			-- Number of tiles in tilesheet

258 169 169 169 169 169 169 169 169 169 169 169 169 169 262
288 199 199 199 199 199 199 199 199 199 199 199 199 199 292
318 229 229 229 201 229 229 229 229 229 229 201 229 229 322
348 210 210 210 231 210 210 210 210 210 210 231 210 210 352
227 340 341 210 210 210 210 210 210 210 210 210 340 341 225
227 370 371 210 210 245 246 246 246 246 247 210 370 371 225
227 210 210 210 202 305 306 306 306 306 307 202 210 210 225
227 340 341 210 232 210 210 210 210 210 210 232 340 341 225
227 370 371 210 210 210 210 210 210 210 210 210 370 371 225
379 196 196 196 196 157 158 158 158 158 159 196 196 196 381
