TILEMAP
15 10 			-- Size of tile map in tiles
16 16 			-- Tile size & block size
images/TileMap2.png 	-- Tilesheet
30 20 			-- Number of tiles in tilesheet

258 256 256 256 259 257 240 210 210 210 255 256 261 260 262
288 286 286 286 286 287 240 210 210 210 285 286 286 286 292
318 316 316 316 201 317 240 210 210 210 315 201 316 316 322
348 245 246 247 231 210 182 183 183 303 210 231 210 210 352
257 275 337 277 210 210 243 273 273 304 210 210 210 210 255
287 275 367 277 210 210 243 273 273 304 210 210 210 210 285
317 305 306 307 241 242 243 273 273 304 241 242 210 210 315
210 210 210 210 271 272 243 273 273 304 271 272 210 210 210
197 210 210 210 301 302 243 273 273 304 301 302 210 210 195
379 196 196 196 196 197 342 213 274 343 195 196 196 196 381
