TILEMAP
15 10 			-- Size of tile map in tiles
16 16 			-- Tile size & block size
images/TileMap2.png 	-- Tilesheet
30 20 			-- Number of tiles in tilesheet

24 85 85 85 85 85 85 85 85 85 85 85 85 85 86
54 22 43 43 43 23 43 43 22 43 43 43 43 22 116
54 43 43 43 43 43 43 177 174 174 174 174 176 43 116
54 108 109 110 43 43 43 145 171 171 171 171 143 43 116
54 43 43 43 43 43 43 147 114 114 114 114 146 43 116
54 177 174 174 43 43 81 21 21 21 18 19 20 21 53
54 145 142 171 143 43 116 27 28 28 28 28 28 28 29
54 145 172 171 143 43 116 57 56 56 56 56 56 56 59
54 147 114 114 146 23 116 57 56 56 56 56 56 56 59
55 21 21 21 21 21 53 87 88 88 88 88 88 88 89
