TILEMAP
15 10 			-- Size of tile map in tiles
16 16 			-- Tile size & block size
images/TileMap2.png 	-- Tilesheet
30 20 			-- Number of tiles in tilesheet

42 103 104 44 42 9 10 10 10 11 44 12 13 13 14
42 133 134 44 42 39 40 40 40 41 44 72 75 75 74
72 75 75 74 72 69 70 70 70 71 74 73 73 23 12
43 73 43 43 73 99 100 100 100 101 73 73 43 43 72
121 73 73 73 22 73 43 43 43 73 22 73 43 43 22
30 43 23 73 73 73 73 73 73 73 73 73 73 73 12
30 73 73 73 43 23 43 73 43 73 43 73 23 43 42
151 73 43 73 73 73 73 73 73 47 17 73 73 73 72
22 73 73 73 43 43 73 23 73 72 74 73 43 73 22
13 14 22 12 13 13 13 13 13 14 22 12 13 13 13
