TILEMAP
15 10 			-- Size of tile map in tiles
16 16 			-- Tile size & block size
images/TileMap2.png 	-- Tilesheet
30 20 			-- Number of tiles in tilesheet

288 289 290 291 199 199 336 199 199 199 199 289 290 291 292
318 319 320 321 334 335 366 229 229 229 229 319 320 321 322
348 210 210 210 364 365 396 210 210 210 210 210 210 210 352
250 246 246 247 330 332 210 210 195 196 196 196 196 196 381
280 278 279 277 360 362 363 210 255 256 256 256 256 256 256
310 306 306 307 390 392 210 210 285 286 286 286 286 286 286
227 210 210 210 420 422 210 210 315 316 316 316 316 316 316
227 210 210 210 210 210 210 210 210 210 210 210 210 210 210
379 380 380 380 380 380 380 380 380 380 380 380 380 380 380
256 256 256 256 256 256 256 256 256 256 256 256 256 256 256
