TILEMAP
15 10 			-- Size of tile map in tiles
16 16 			-- Tile size & block size
images/TileMap2.png 	-- Tilesheet
30 20 			-- Number of tiles in tilesheet


33 34 3 4 3 4 3 4 3 4 3 4 3 4 3
3 4 33 34 33 34 33 34 33 34 33 34 33 34 33
33 34 63 64 63 64 63 64 63 64 63 64 63 64 63
3 4 65 36 35 35 36 35 68 35 65 68 35 97 36
33 34 65 68 35 0 1 1 1 1 1 1 1 1 1
3 4 36 35 35 30 31 31 31 31 31 31 31 31 31
33 34 35 97 35 60 61 61 61 61 61 61 61 61 61
3 4 35 65 35 68 35 65 36 97 35 36 68 68 35
33 34 5 6 5 6 5 6 5 6 5 6 5 6 5
3 4 33 34 33 34 33 34 33 34 33 34 33 34 33
