TILEMAP
15 10 			-- Size of tile map in tiles
16 16 			-- Tile size & block size
images/TileMap2.png 	-- Tilesheet
30 20 			-- Number of tiles in tilesheet

3 4 63 64 63 64 63 64 63 64 63 64 63 64 3
33 34 35 36 65 66 36 65 66 35 38 66 97 38 33
63 64 65 97 0 1 1 1 1 2 65 38 38 65 3
65 38 66 35 30 47 13 17 31 32 38 65 38 65 33
1 1 1 1 151 72 75 74 31 150 2 5 6 8 3
31 31 31 31 31 31 31 31 31 31 32 33 34 38 33
61 61 61 61 61 61 61 61 121 31 32 3 4 68 3
35 97 38 66 38 66 97 65 30 31 32 33 34 8 33
38 36 36 38 36 38 66 35 30 31 32 3 4 38 3
5 6 5 6 5 6 5 6 30 31 32 33 34 68 33
