TILEMAP
15 10 			-- Size of tile map in tiles
16 16 			-- Tile size & block size
images/TileMap2.png 	-- Tilesheet
30 20 			-- Number of tiles in tilesheet

4 3 4 3 4 3 4 203 207 204 207 207 204 207 209
34 33 34 33 34 33 34 233 235 234 235 237 234 235 239
64 63 64 63 64 63 64 263 264 265 266 266 267 264 269
102 106 106 106 105 38 38 293 294 295 296 296 297 294 299
132 103 107 104 135 38 38 97 97 325 326 326 327 97 92
132 133 166 134 135 65 66 36 66 35 36 36 65 65 92
162 164 163 164 165 35 7 37 67 65 66 35 7 67 92
6 192 193 193 193 193 194 36 38 35 38 35 38 36 92
34 252 253 253 253 253 254 38 65 38 65 66 36 38 93
64 5 6 5 6 5 6 5 6 5 6 5 6 5 6