TILEMAP
15 10 			-- Size of tile map in tiles
16 16 			-- Tile size & block size
images/TileMap2.png 	-- Tilesheet
30 20 			-- Number of tiles in tilesheet

24 25 25 25 25 25 25 25 25 25 85 85 85 85 86
54 43 22 43 81 82 83 43 43 43 43 177 174 176 116
54 23 43 22 116 56 54 22 43 23 43 145 112 143 116
54 43 43 43 116 56 54 43 43 43 43 147 114 146 116
54 43 43 23 84 85 26 43 23 43 23 43 23 43 116
54 43 22 43 43 43 43 43 43 43 43 43 43 43 116
54 43 22 43 43 22 43 43 23 43 43 22 43 23 116
54 43 23 43 23 22 48 49 50 43 43 43 43 43 116
51 43 43 43 43 22 78 79 80 43 43 23 43 22 116
55 21 21 21 21 21 18 19 20 21 21 21 21 21 53

