TILEMAP
15 10 			-- Size of tile map in tiles
16 16 			-- Tile size & block size
images/TileMap2.png 	-- Tilesheet
30 20 			-- Number of tiles in tilesheet

4 33 34 30 31 32 66 154 155 155 155 155 155 156 3
34 63 64 30 31 32 97 184 185 185 185 185 185 186 33
64 38 38 30 31 32 65 66 38 38 38 38 38 36 63
35 97 65 30 31 150 1 1 1 1 2 65 97 38 65
1 1 1 151 31 31 31 31 31 31 32 38 66 35 65
31 31 31 31 31 120 61 61 121 31 150 1 1 1 1
61 61 61 61 61 62 38 38 30 31 31 31 31 31 31
65 38 36 38 97 38 38 38 60 61 61 61 61 61 61
5 6 5 6 5 6 5 6 5 6 5 6 5 6 5
33 34 33 34 33 34 33 34 33 34 33 34 33 34 33
