TILEMAP
15 10 			-- Size of tile map in tiles
16 16 			-- Tile size & block size
images/TileMap2.png 	-- Tilesheet
30 20 			-- Number of tiles in tilesheet

3 4 3 4 3 4 3 4 3 4 3 4 3 4 3
33 34 33 34 33 34 33 34 33 34 33 34 33 34 33
3 4 63 64 63 64 63 64 63 64 63 64 63 64 63
33 34 97 36 66 36 66 38 35 35 36 65 97 65 35
3 4 66 66 97 38 97 65 38 65 66 0 1 1 1
33 34 35 36 38 65 38 66 35 36 35 30 31 31 31
3 4 66 36 97 38 97 65 66 36 65 60 61 61 61
33 34 38 66 35 36 35 38 66 97 66 35 36 38 35
3 4 5 6 5 6 5 6 5 6 5 6 5 6 5
33 34 33 34 33 34 33 34 33 34 33 34 33 34 33
