TILEMAP
15 10 			-- Size of tile map in tiles
16 16 			-- Tile size & block size
images/TileMap2.png 	-- Tilesheet
30 20 			-- Number of tiles in tilesheet

168 169 169 169 169 169 169 169 169 169 257 210 210 255 170
198 199 199 199 199 199 199 199 199 199 287 210 210 285 200
228 229 229 229 229 229 229 229 229 229 317 210 210 315 230
227 282 283 284 330 331 332 282 283 284 210 210 210 210 225
257 312 313 314 390 391 392 312 313 314 210 340 246 247 225
287 210 210 394 420 421 422 210 210 245 246 369 398 277 225
317 210 210 210 210 210 210 210 210 275 248 278 279 277 225
210 210 210 210 210 210 210 210 210 305 306 306 306 307 225
196 196 196 196 196 196 196 196 196 196 196 196 196 196 381
256 256 256 256 256 256 256 256 256 256 256 256 256 256 256
